####################
#@.##........#...#.#
#...#..#.#.#.###.#.#
###.#..#.###.......#
#.....##.#..##.#..##
##.#####.....#####.#
#.....#..##...#..#.#
#.##.##.#####.#.#..#
#.#..#...#........##
####################