####################
#...#....###.#.###.#
#.####.#..#..#..#..#
#.#.##.##.......#.##
#......#.#@.##.#..##
##.#####.....####..#
#..#..#..##.#...#..#
#.##.##.##..#.#.#.##
#........#....#....#
####################